█████████████████████████████████████████
█     s █           █ ➡   ➡   ➡ █       █
█   █   █   █   █████   █   █   █████   █
█     ➡   ➡   ➡   ➡   ➡ █   █ ➡ █       █
█████████   █████████████   █   █   █   █
█       █           █       █ ➡   ➡   ➡ █
█   █   █████████   █   █████████████   █
█   █   █   █       █   █   █   █   █ ➡ █
█   █   █████   █████   █████████████   █
█       █   █                   █   █ ➡ █
█████   █████████████████████████████   █
█       █   █   █   █   █   █   █   █ ➡ █
█   █   █████████████   █████████████   █
█   █           █   █   █   █         ➡ █
█   █   █████████████   █████████████   █
█   █   █       █   █   █   █   █   █ ➡ █
█   █   █   █   █████   █████████████   █
█   █   █           █               █ ➡ █
█   █████   █████   █   █   █████   █   █
█               █     e   ➡   ➡   ➡   ➡ █
█████████████████████████████████████████
