█████████████████████████████████
█     s   ➡   ➡   ➡   ➡   ➡     █
█████   █   █████████████   █   █
█       █   █         e   ➡ █   █
█   █████   █   █   █████   █   █
█   █       █   █   █       █   █
█████████████████   █   █████   █
█                   █   █       █
█   █   █████   █   █████   █   █
█   █   █       █   █       █   █
█   █████   █   █████████████   █
█   █       █   █               █
█████████   █   █   █████████   █
█           █   █   █           █
█   █████   █   █   █████████   █
█   █       █   █   █           █
█████████   █████████████████   █
█           █                   █
█████████████████████████████████
