9151115113
8016EA9002
EAC512EEEA
92F942FFFA
AAFC5057FA
EAFFFAFFFA
D6D3FAFD52
D512FAFFFA
9102929112
C6EEEEEEC6

0,0
8,5
SEESEESESSSSS