█████████████████████████████████
█               █               █
█   █████████   █   █████████   █
█   █   █[42m   [0m█   █[41m   [0m    █   █   █
█   █   █   █   █████   █   █   █
█       █       █   █   █       █
█   █   █████████   █   █   █   █
█       █       █       █   █   █
█   █   █████   █   █   █   █   █
█       █       █           █   █
█████   █   █   █████████   █   █
█       █   █   █               █
█   █   █   █████   █████████   █
█   █           █   █           █
█   █████████   █   █   █   █████
█   █       █       █           █
█   █   █   █████   █████   █   █
█       █                       █
█████████████████████████████████
